111111111
100101001
100001001
100001001
111111111