11111111
10011001
10000001
10011001
10011001
10000101
10011001
11111111